   NO  textures/north.xpm
SO          textures/south.xpm
         WE textures/west.xpm       
EA textures/east.xpm
  

         

  F     32,42,42
C   200,30,0

        1111111
       1100001111111111
1111111000011111111111
10000000000001111111111
101111111111111
101
1N01
111111111111111
111111111111111
111111111111111
111101111111111
111111111111111
111111111111111
111111111111111
111111111111111