NO textures/north.xpm
SO textures/south.xpm
WE textures/west.xpm
EA textures/east.xpm

F 220,100,2
C 225,30,0


111111
100101           11
100001           1E1 
100001           111  
111111
111111
111111
