NO textures/north.xpm
SO textures/south.xpm
WE textures/west.xpm
EA textures/east.xpm

F 220,100,2
C 225,30,0

11111111111111
11000010111111111
1111111000001111111
10000000000001111111111
101111111111111
1011
1011
101111111111111
10E011111111111
111111111111111
111101111111111
111111111111111
111111111111111
111111111111111
111111111111111

