NO  textures/north.xpm
SO textures/south.xpm
WE textures/west.xpm       
EA textures/east.xpm

F 220,100,2
C 225,30,0

11111
10001
10001
10001
10001
10001
111E1
10001
10001
10001
10001
10001
11111
